1111111111111111111111111111111
1E0000000000000C00C000000000001
1010010100100000101000000010101
1010010010101010001000000010101
1E00A0000000000C00000011A000001
1010010010101010CCC100000010101
1E00A0000000000C000000000AA0001
1010000100000101001000000010101
1E0000000A00C00000C0000000A0001
1010100100000101000000000010101
101001010101000101100A000010101
1PC000001C00000001110000E00A0C1
1010010010101001001000000010101
1E00A0000000000000C000000AA1001
100000000C00C0000000000000000C1
1111111111111111111111111111111